UNITID,ARANK,XEMPCNTM,EMPCNTM,XEMPCNTW,EMPCNTW,XEMPCNTT,EMPCNTT 
100760,6,"Z",0,"R",1,"R",1
100760,7,"Z",0,"R",1,"R",1
101161,6,"R",1,"R",1,"R",2
101161,7,"R",1,"R",1,"R",2
101240,6,"Z",0,"R",1,"R",1
101240,7,"Z",0,"R",1,"R",1
101286,6,"R",1,"Z",0,"R",1
101286,7,"R",1,"Z",0,"R",1
101462,6,"R",1,"R",3,"R",4
101462,7,"R",1,"R",3,"R",4
101471,6,"R",1,"Z",0,"R",1
101471,7,"R",1,"Z",0,"R",1
101505,6,"R",1,"R",3,"R",4
101505,7,"R",1,"R",3,"R",4
101514,6,"R",1,"Z",0,"R",1
101514,7,"R",1,"Z",0,"R",1
101736,6,"R",1,"Z",0,"R",1
101736,7,"R",1,"Z",0,"R",1
101897,6,"Z",0,"R",1,"R",1
101897,7,"Z",0,"R",1,"R",1
102030,6,"Z",0,"R",2,"R",2
102030,7,"Z",0,"R",2,"R",2
102067,6,"R",1,"Z",0,"R",1
102067,7,"R",1,"Z",0,"R",1
102313,6,"R",3,"R",6,"R",9
102313,7,"R",3,"R",6,"R",9
102368,1,"R",5,"R",7,"R",12
102368,2,"R",7,"R",5,"R",12
102368,3,"R",1,"Z",0,"R",1
102368,5,"R",1,"Z",0,"R",1
102368,7,"R",14,"R",12,"R",26
102669,2,"R",1,"Z",0,"R",1
102669,7,"R",1,"Z",0,"R",1
104188,4,"R",1,"R",1,"R",2
104188,7,"R",1,"R",1,"R",2
104577,4,"R",1,"Z",0,"R",1
104577,7,"R",1,"Z",0,"R",1
105659,4,"R",11,"Z",0,"R",11
105659,7,"R",11,"Z",0,"R",11
106883,6,"R",1,"R",1,"R",2
106883,7,"R",1,"R",1,"R",2
108667,4,"Z",0,"R",1,"R",1
108667,7,"Z",0,"R",1,"R",1
108807,4,"R",6,"R",7,"R",13
108807,7,"R",6,"R",7,"R",13
109208,4,"Z",0,"R",1,"R",1
109208,7,"Z",0,"R",1,"R",1
109785,1,"R",1,"Z",0,"R",1
109785,7,"R",1,"Z",0,"R",1
109819,4,"Z",0,"R",1,"R",1
109819,7,"Z",0,"R",1,"R",1
110060,1,"R",2,"R",1,"R",3
110060,7,"R",2,"R",1,"R",3
111391,1,"R",1,"Z",0,"R",1
111391,7,"R",1,"Z",0,"R",1
111434,4,"R",3,"R",4,"R",7
111434,7,"R",3,"R",4,"R",7
111887,4,"R",1,"R",1,"R",2
111887,7,"R",1,"R",1,"R",2
111896,4,"R",1,"Z",0,"R",1
111896,7,"R",1,"Z",0,"R",1
111920,4,"R",5,"R",6,"R",11
111920,7,"R",5,"R",6,"R",11
111939,4,"R",4,"R",6,"R",10
111939,7,"R",4,"R",6,"R",10
111948,1,"R",1,"Z",0,"R",1
111948,4,"Z",0,"R",2,"R",2
111948,7,"R",1,"R",2,"R",3
112172,4,"Z",0,"R",2,"R",2
112172,7,"Z",0,"R",2,"R",2
112190,4,"R",9,"R",28,"R",37
112190,7,"R",9,"R",28,"R",37
112385,4,"R",1,"R",2,"R",3
112385,7,"R",1,"R",2,"R",3
112561,4,"R",9,"R",1,"R",10
112561,7,"R",9,"R",1,"R",10
112826,4,"R",11,"R",14,"R",25
112826,7,"R",11,"R",14,"R",25
113193,4,"R",10,"R",12,"R",22
113193,7,"R",10,"R",12,"R",22
113236,4,"R",4,"R",4,"R",8
113236,7,"R",4,"R",4,"R",8
113573,4,"R",3,"Z",0,"R",3
113573,7,"R",3,"Z",0,"R",3
113634,4,"R",9,"R",14,"R",23
113634,7,"R",9,"R",14,"R",23
113980,4,"R",1,"R",1,"R",2
113980,7,"R",1,"R",1,"R",2
114266,4,"Z",0,"R",3,"R",3
114266,7,"Z",0,"R",3,"R",3
114433,4,"R",2,"Z",0,"R",2
114433,7,"R",2,"Z",0,"R",2
114789,4,"R",1,"R",5,"R",6
114789,7,"R",1,"R",5,"R",6
114859,4,"R",2,"R",2,"R",4
114859,7,"R",2,"R",2,"R",4
114938,4,"R",4,"R",10,"R",14
114938,7,"R",4,"R",10,"R",14
115001,4,"R",4,"R",2,"R",6
115001,7,"R",4,"R",2,"R",6
115126,4,"R",1,"R",2,"R",3
115126,7,"R",1,"R",2,"R",3
115393,4,"R",3,"R",2,"R",5
115393,7,"R",3,"R",2,"R",5
116439,4,"R",2,"R",1,"R",3
116439,7,"R",2,"R",1,"R",3
117052,4,"R",2,"R",2,"R",4
117052,7,"R",2,"R",2,"R",4
117195,4,"R",2,"R",8,"R",10
117195,7,"R",2,"R",8,"R",10
117247,4,"R",6,"R",1,"R",7
117247,7,"R",6,"R",1,"R",7
117894,4,"R",11,"R",4,"R",15
117894,7,"R",11,"R",4,"R",15
118772,4,"Z",0,"R",1,"R",1
118772,7,"Z",0,"R",1,"R",1
118912,4,"R",4,"R",20,"R",24
118912,7,"R",4,"R",20,"R",24
118930,4,"R",6,"R",2,"R",8
118930,7,"R",6,"R",2,"R",8
118976,4,"R",4,"R",1,"R",5
118976,7,"R",4,"R",1,"R",5
119067,4,"R",1,"Z",0,"R",1
119067,7,"R",1,"Z",0,"R",1
119331,4,"Z",0,"R",3,"R",3
119331,7,"Z",0,"R",3,"R",3
120421,4,"Z",0,"R",1,"R",1
120421,7,"Z",0,"R",1,"R",1
120883,3,"R",1,"Z",0,"R",1
120883,7,"R",1,"Z",0,"R",1
121044,4,"R",4,"R",12,"R",16
121044,7,"R",4,"R",12,"R",16
121619,4,"R",2,"R",5,"R",7
121619,7,"R",2,"R",5,"R",7
121901,4,"Z",0,"R",3,"R",3
121901,7,"Z",0,"R",3,"R",3
122180,4,"Z",0,"R",1,"R",1
122180,7,"Z",0,"R",1,"R",1
122205,4,"R",3,"R",8,"R",11
122205,7,"R",3,"R",8,"R",11
122339,4,"R",21,"R",15,"R",36
122339,7,"R",21,"R",15,"R",36
122375,4,"R",9,"R",13,"R",22
122375,7,"R",9,"R",13,"R",22
122384,4,"R",7,"R",5,"R",12
122384,7,"R",7,"R",5,"R",12
122658,4,"R",3,"R",3,"R",6
122658,7,"R",3,"R",3,"R",6
122746,4,"Z",0,"R",1,"R",1
122746,7,"Z",0,"R",1,"R",1
122791,4,"R",1,"R",7,"R",8
122791,7,"R",1,"R",7,"R",8
122889,4,"R",29,"R",58,"R",87
122889,7,"R",29,"R",58,"R",87
122977,4,"R",1,"Z",0,"R",1
122977,7,"R",1,"Z",0,"R",1
123013,4,"R",7,"R",3,"R",10
123013,7,"R",7,"R",3,"R",10
123217,4,"R",2,"R",6,"R",8
123217,7,"R",2,"R",6,"R",8
123299,4,"R",1,"Z",0,"R",1
123299,7,"R",1,"Z",0,"R",1
123509,4,"R",5,"R",4,"R",9
123509,7,"R",5,"R",4,"R",9
123563,4,"R",1,"Z",0,"R",1
123563,7,"R",1,"Z",0,"R",1
125028,4,"Z",0,"R",1,"R",1
125028,7,"Z",0,"R",1,"R",1
125091,4,"R",5,"R",2,"R",7
125091,7,"R",5,"R",2,"R",7
125170,4,"R",1,"R",4,"R",5
125170,7,"R",1,"R",4,"R",5
125499,4,"Z",0,"R",1,"R",1
125499,7,"Z",0,"R",1,"R",1
126863,6,"R",2,"R",2,"R",4
126863,7,"R",2,"R",2,"R",4
126872,1,"R",1,"R",2,"R",3
126872,7,"R",1,"R",2,"R",3
127060,5,"R",1,"Z",0,"R",1
127060,7,"R",1,"Z",0,"R",1
127389,6,"R",1,"Z",0,"R",1
127389,7,"R",1,"Z",0,"R",1
129534,1,"Z",0,"R",1,"R",1
129534,2,"R",1,"Z",0,"R",1
129534,4,"R",4,"Z",0,"R",4
129534,7,"R",5,"R",1,"R",6
130794,3,"R",1,"Z",0,"R",1
130794,5,"R",5,"R",2,"R",7
130794,7,"R",6,"R",2,"R",8
132471,2,"R",1,"Z",0,"R",1
132471,3,"R",1,"R",1,"R",2
132471,7,"R",2,"R",1,"R",3
135063,4,"R",2,"R",3,"R",5
135063,7,"R",2,"R",3,"R",5
135726,1,"Z",0,"R",1,"R",1
135726,7,"Z",0,"R",1,"R",1
139658,1,"R",2,"R",1,"R",3
139658,2,"R",1,"Z",0,"R",1
139658,3,"Z",0,"R",1,"R",1
139658,6,"R",34,"R",32,"R",66
139658,7,"R",37,"R",34,"R",71
139755,6,"R",6,"R",3,"R",9
139755,7,"R",6,"R",3,"R",9
140234,6,"Z",0,"R",1,"R",1
140234,7,"Z",0,"R",1,"R",1
142115,5,"Z",0,"R",2,"R",2
142115,7,"Z",0,"R",2,"R",2
142522,6,"R",31,"R",11,"R",42
142522,7,"R",31,"R",11,"R",42
144050,1,"R",11,"R",2,"R",13
144050,2,"Z",0,"R",1,"R",1
144050,3,"R",3,"Z",0,"R",3
144050,5,"R",1,"R",3,"R",4
144050,7,"R",15,"R",6,"R",21
144892,4,"R",1,"R",2,"R",3
144892,7,"R",1,"R",2,"R",3
145600,5,"R",2,"R",1,"R",3
145600,7,"R",2,"R",1,"R",3
145637,3,"Z",0,"R",1,"R",1
145637,7,"Z",0,"R",1,"R",1
145813,5,"R",10,"R",17,"R",27
145813,7,"R",10,"R",17,"R",27
149231,4,"Z",0,"R",1,"R",1
149231,5,"R",1,"R",1,"R",2
149231,7,"R",1,"R",2,"R",3
149772,1,"R",1,"R",1,"R",2
149772,2,"R",1,"R",1,"R",2
149772,3,"Z",0,"R",3,"R",3
149772,4,"R",5,"Z",0,"R",5
149772,7,"R",7,"R",5,"R",12
150136,3,"R",2,"R",1,"R",3
150136,4,"R",3,"R",7,"R",10
150136,7,"R",5,"R",8,"R",13
151324,5,"R",19,"R",14,"R",33
151324,7,"R",19,"R",14,"R",33
151467,4,"Z",0,"R",1,"R",1
151467,7,"Z",0,"R",1,"R",1
152637,6,"R",10,"R",17,"R",27
152637,7,"R",10,"R",17,"R",27
154095,1,"R",1,"Z",0,"R",1
154095,3,"Z",0,"R",1,"R",1
154095,4,"R",5,"R",10,"R",15
154095,5,"R",1,"Z",0,"R",1
154095,7,"R",7,"R",11,"R",18
154262,4,"Z",0,"R",1,"R",1
154262,7,"Z",0,"R",1,"R",1
157085,1,"R",6,"R",1,"R",7
157085,2,"R",1,"Z",0,"R",1
157085,3,"R",2,"Z",0,"R",2
157085,4,"R",13,"R",6,"R",19
157085,5,"R",2,"Z",0,"R",2
157085,7,"R",24,"R",7,"R",31
157377,6,"Z",0,"R",1,"R",1
157377,7,"Z",0,"R",1,"R",1
157447,1,"R",1,"Z",0,"R",1
157447,5,"R",2,"Z",0,"R",2
157447,7,"R",3,"Z",0,"R",3
157951,4,"R",1,"R",4,"R",5
157951,6,"Z",0,"R",1,"R",1
157951,7,"R",1,"R",5,"R",6
158088,4,"R",1,"Z",0,"R",1
158088,7,"R",1,"Z",0,"R",1
158662,6,"R",1,"Z",0,"R",1
158662,7,"R",1,"Z",0,"R",1
159391,2,"R",1,"Z",0,"R",1
159391,4,"R",11,"R",9,"R",20
159391,7,"R",12,"R",9,"R",21
159647,1,"R",1,"Z",0,"R",1
159647,7,"R",1,"Z",0,"R",1
159656,4,"Z",0,"R",1,"R",1
159656,5,"R",3,"R",4,"R",7
159656,7,"R",3,"R",5,"R",8
159939,3,"R",1,"Z",0,"R",1
159939,4,"R",2,"R",2,"R",4
159939,7,"R",3,"R",2,"R",5
160409,1,"R",10,"Z",0,"R",10
160409,7,"R",10,"Z",0,"R",10
160612,4,"R",2,"R",7,"R",9
160612,7,"R",2,"R",7,"R",9
160621,1,"R",2,"Z",0,"R",2
160621,3,"Z",0,"R",2,"R",2
160621,4,"R",1,"R",4,"R",5
160621,5,"R",4,"R",7,"R",11
160621,7,"R",7,"R",13,"R",20
160904,3,"R",1,"R",4,"R",5
160904,4,"R",2,"Z",0,"R",2
160904,5,"R",2,"R",1,"R",3
160904,7,"R",5,"R",5,"R",10
161299,1,"R",11,"R",4,"R",15
161299,2,"R",13,"R",6,"R",19
161299,3,"R",18,"R",4,"R",22
161299,4,"R",1,"R",1,"R",2
161299,5,"R",1,"Z",0,"R",1
161299,7,"R",44,"R",15,"R",59
161457,5,"Z",0,"R",2,"R",2
161457,7,"Z",0,"R",2,"R",2
162557,5,"Z",0,"R",1,"R",1
162557,7,"Z",0,"R",1,"R",1
162584,5,"Z",0,"R",2,"R",2
162584,7,"Z",0,"R",2,"R",2
162690,4,"Z",0,"R",1,"R",1
162690,6,"Z",0,"R",1,"R",1
162690,7,"Z",0,"R",2,"R",2
162928,4,"R",3,"R",4,"R",7
162928,5,"R",2,"R",11,"R",13
162928,6,"R",3,"Z",0,"R",3
162928,7,"R",8,"R",15,"R",23
163204,1,"Z",0,"R",1,"R",1
163204,7,"Z",0,"R",1,"R",1
163259,6,"R",1,"R",5,"R",6
163259,7,"R",1,"R",5,"R",6
163426,5,"R",1,"Z",0,"R",1
163426,7,"R",1,"Z",0,"R",1
164580,1,"R",5,"Z",0,"R",5
164580,2,"R",3,"Z",0,"R",3
164580,5,"Z",0,"R",1,"R",1
164580,7,"R",8,"R",1,"R",9
164988,5,"Z",0,"R",1,"R",1
164988,6,"R",1,"R",1,"R",2
164988,7,"R",1,"R",2,"R",3
166683,6,"R",1,"Z",0,"R",1
166683,7,"R",1,"Z",0,"R",1
167996,2,"R",1,"Z",0,"R",1
167996,7,"R",1,"Z",0,"R",1
168148,1,"Z",0,"R",1,"R",1
168148,2,"Z",0,"R",1,"R",1
168148,3,"R",1,"Z",0,"R",1
168148,4,"Z",0,"R",1,"R",1
168148,7,"R",1,"R",3,"R",4
169275,6,"Z",0,"R",2,"R",2
169275,7,"Z",0,"R",2,"R",2
169910,6,"R",23,"R",15,"R",38
169910,7,"R",23,"R",15,"R",38
170055,2,"R",3,"R",1,"R",4
170055,3,"R",1,"R",3,"R",4
170055,4,"R",1,"R",1,"R",2
170055,7,"R",5,"R",5,"R",10
170541,6,"R",6,"R",5,"R",11
170541,7,"R",6,"R",5,"R",11
170976,1,"R",10,"R",2,"R",12
170976,3,"R",2,"Z",0,"R",2
170976,5,"R",37,"R",44,"R",81
170976,7,"R",49,"R",46,"R",95
171146,5,"R",11,"R",12,"R",23
171146,7,"R",11,"R",12,"R",23
172972,4,"Z",0,"R",1,"R",1
172972,7,"Z",0,"R",1,"R",1
173142,4,"R",1,"Z",0,"R",1
173142,7,"R",1,"Z",0,"R",1
175573,6,"Z",0,"R",1,"R",1
175573,7,"Z",0,"R",1,"R",1
175935,4,"Z",0,"R",1,"R",1
175935,7,"Z",0,"R",1,"R",1
176017,1,"Z",0,"R",1,"R",1
176017,2,"R",1,"Z",0,"R",1
176017,3,"R",2,"R",1,"R",3
176017,4,"R",5,"R",5,"R",10
176017,7,"R",8,"R",7,"R",15
176035,4,"Z",0,"R",2,"R",2
176035,7,"Z",0,"R",2,"R",2
176239,4,"R",4,"R",27,"R",31
176239,7,"R",4,"R",27,"R",31
176479,3,"Z",0,"R",1,"R",1
176479,7,"Z",0,"R",1,"R",1
176619,1,"R",5,"R",2,"R",7
176619,2,"R",1,"Z",0,"R",1
176619,7,"R",6,"R",2,"R",8
178396,3,"R",1,"R",1,"R",2
178396,4,"R",1,"R",8,"R",9
178396,6,"R",1,"R",3,"R",4
178396,7,"R",3,"R",12,"R",15
178402,4,"R",2,"R",1,"R",3
178402,7,"R",2,"R",1,"R",3
178411,1,"R",2,"Z",0,"R",2
178411,2,"R",1,"Z",0,"R",1
178411,5,"Z",0,"R",2,"R",2
178411,7,"R",3,"R",2,"R",5
178420,6,"R",1,"Z",0,"R",1
178420,7,"R",1,"Z",0,"R",1
178721,4,"Z",0,"R",1,"R",1
178721,7,"Z",0,"R",1,"R",1
179867,1,"R",2,"Z",0,"R",2
179867,3,"R",1,"Z",0,"R",1
179867,5,"R",2,"R",6,"R",8
179867,6,"Z",0,"R",2,"R",2
179867,7,"R",5,"R",8,"R",13
180692,4,"R",3,"R",1,"R",4
180692,7,"R",3,"R",1,"R",4
181394,4,"Z",0,"R",1,"R",1
181394,5,"Z",0,"R",1,"R",1
181394,7,"Z",0,"R",2,"R",2
181428,4,"Z",0,"R",2,"R",2
181428,7,"Z",0,"R",2,"R",2
181464,3,"Z",0,"R",3,"R",3
181464,5,"R",2,"R",2,"R",4
181464,7,"R",2,"R",5,"R",7
181783,3,"R",1,"Z",0,"R",1
181783,4,"Z",0,"R",1,"R",1
181783,7,"R",1,"R",1,"R",2
182670,3,"Z",0,"R",1,"R",1
182670,7,"Z",0,"R",1,"R",1
183743,5,"R",38,"R",56,"R",94
183743,7,"R",38,"R",56,"R",94
184995,6,"R",10,"R",5,"R",15
184995,7,"R",10,"R",5,"R",15
185536,6,"R",3,"R",8,"R",11
185536,7,"R",3,"R",8,"R",11
187198,4,"Z",0,"R",1,"R",1
187198,7,"Z",0,"R",1,"R",1
187620,4,"Z",0,"R",1,"R",1
187620,6,"Z",0,"R",1,"R",1
187620,7,"Z",0,"R",2,"R",2
187994,6,"R",1,"Z",0,"R",1
187994,7,"R",1,"Z",0,"R",1
188003,4,"Z",0,"R",1,"R",1
188003,6,"Z",0,"R",1,"R",1
188003,7,"Z",0,"R",2,"R",2
188021,4,"Z",0,"R",1,"R",1
188021,7,"Z",0,"R",1,"R",1
188030,4,"Z",0,"R",1,"R",1
188030,6,"Z",0,"R",3,"R",3
188030,7,"Z",0,"R",4,"R",4
189547,3,"R",5,"R",7,"R",12
189547,6,"R",6,"R",13,"R",19
189547,7,"R",11,"R",20,"R",31
190099,1,"R",6,"R",2,"R",8
190099,7,"R",6,"R",2,"R",8
190415,1,"R",5,"R",2,"R",7
190415,2,"R",4,"Z",0,"R",4
190415,3,"R",2,"R",1,"R",3
190415,5,"R",2,"R",3,"R",5
190415,7,"R",13,"R",6,"R",19
192040,6,"Z",0,"R",1,"R",1
192040,7,"Z",0,"R",1,"R",1
192819,3,"Z",0,"R",1,"R",1
192819,5,"R",1,"Z",0,"R",1
192819,7,"R",1,"R",1,"R",2
194116,6,"R",3,"R",3,"R",6
194116,7,"R",3,"R",3,"R",6
194824,5,"R",1,"Z",0,"R",1
194824,7,"R",1,"Z",0,"R",1
195687,2,"Z",0,"R",3,"R",3
195687,7,"Z",0,"R",3,"R",3
195809,3,"Z",0,"R",2,"R",2
195809,7,"Z",0,"R",2,"R",2
196006,4,"R",7,"R",9,"R",16
196006,5,"R",1,"R",1,"R",2
196006,7,"R",8,"R",10,"R",18
196015,3,"Z",0,"R",1,"R",1
196015,4,"R",8,"R",11,"R",19
196015,5,"R",1,"R",1,"R",2
196015,7,"R",9,"R",13,"R",22
196042,1,"R",1,"Z",0,"R",1
196042,7,"R",1,"Z",0,"R",1
196051,3,"Z",0,"R",1,"R",1
196051,4,"R",1,"R",1,"R",2
196051,5,"Z",0,"R",4,"R",4
196051,7,"R",1,"R",6,"R",7
196060,3,"R",6,"R",3,"R",9
196060,5,"R",1,"R",5,"R",6
196060,7,"R",7,"R",8,"R",15
196079,1,"R",4,"R",2,"R",6
196079,3,"R",6,"R",2,"R",8
196079,4,"R",1,"R",2,"R",3
196079,5,"Z",0,"R",2,"R",2
196079,7,"R",11,"R",8,"R",19
196097,1,"R",1,"Z",0,"R",1
196097,3,"R",1,"Z",0,"R",1
196097,4,"R",1,"R",5,"R",6
196097,7,"R",3,"R",5,"R",8
196103,5,"Z",0,"R",2,"R",2
196103,7,"Z",0,"R",2,"R",2
196130,5,"R",1,"R",4,"R",5
196130,7,"R",1,"R",4,"R",5
196149,3,"Z",0,"R",1,"R",1
196149,7,"Z",0,"R",1,"R",1
196158,3,"R",1,"Z",0,"R",1
196158,7,"R",1,"Z",0,"R",1
196185,1,"R",1,"Z",0,"R",1
196185,5,"Z",0,"R",1,"R",1
196185,7,"R",1,"R",1,"R",2
196194,3,"R",4,"Z",0,"R",4
196194,4,"R",2,"R",2,"R",4
196194,7,"R",6,"R",2,"R",8
196219,5,"Z",0,"R",4,"R",4
196219,7,"Z",0,"R",4,"R",4
196264,5,"Z",0,"R",3,"R",3
196264,7,"Z",0,"R",3,"R",3
196291,4,"R",3,"Z",0,"R",3
196291,5,"R",7,"R",4,"R",11
196291,7,"R",10,"R",4,"R",14
196389,4,"R",7,"R",10,"R",17
196389,7,"R",7,"R",10,"R",17
198835,4,"R",2,"R",1,"R",3
198835,5,"R",1,"Z",0,"R",1
198835,7,"R",3,"R",1,"R",4
199892,6,"R",2,"Z",0,"R",2
199892,7,"R",2,"Z",0,"R",2
200280,6,"R",1,"Z",0,"R",1
200280,7,"R",1,"Z",0,"R",1
201645,6,"R",1,"Z",0,"R",1
201645,7,"R",1,"Z",0,"R",1
203289,6,"R",4,"Z",0,"R",4
203289,7,"R",4,"Z",0,"R",4
203368,1,"R",2,"Z",0,"R",2
203368,7,"R",2,"Z",0,"R",2
203465,6,"R",1,"Z",0,"R",1
203465,7,"R",1,"Z",0,"R",1
203483,6,"R",1,"Z",0,"R",1
203483,7,"R",1,"Z",0,"R",1
203492,6,"R",1,"R",1,"R",2
203492,7,"R",1,"R",1,"R",2
203517,3,"R",1,"Z",0,"R",1
203517,4,"R",1,"Z",0,"R",1
203517,5,"R",1,"R",1,"R",2
203517,6,"R",1,"Z",0,"R",1
203517,7,"R",4,"R",1,"R",5
203720,4,"R",2,"R",5,"R",7
203720,7,"R",2,"R",5,"R",7
203739,4,"R",3,"R",4,"R",7
203739,7,"R",3,"R",4,"R",7
205470,6,"R",6,"R",7,"R",13
205470,7,"R",6,"R",7,"R",13
205513,4,"Z",0,"R",1,"R",1
205513,7,"Z",0,"R",1,"R",1
205522,4,"Z",0,"R",2,"R",2
205522,7,"Z",0,"R",2,"R",2
205531,4,"R",2,"Z",0,"R",2
205531,7,"R",2,"Z",0,"R",2
205568,4,"Z",0,"R",1,"R",1
205568,7,"Z",0,"R",1,"R",1
206330,1,"R",3,"R",1,"R",4
206330,7,"R",3,"R",1,"R",4
206622,6,"R",1,"R",1,"R",2
206622,7,"R",1,"R",1,"R",2
206862,6,"C",1,"C",0,"C",1
206862,7,"C",1,"C",0,"C",1
207342,3,"Z",0,"R",1,"R",1
207342,7,"Z",0,"R",1,"R",1
207971,3,"Z",0,"R",1,"R",1
207971,7,"Z",0,"R",1,"R",1
209746,4,"R",3,"Z",0,"R",3
209746,7,"R",3,"Z",0,"R",3
210890,4,"R",2,"Z",0,"R",2
210890,7,"R",2,"Z",0,"R",2
211440,5,"R",2,"R",4,"R",6
211440,6,"R",3,"R",3,"R",6
211440,7,"R",5,"R",7,"R",12
211750,4,"R",2,"R",2,"R",4
211750,7,"R",2,"R",2,"R",4
212832,4,"Z",0,"R",1,"R",1
212832,7,"Z",0,"R",1,"R",1
212975,4,"Z",0,"R",1,"R",1
212975,7,"Z",0,"R",1,"R",1
213057,4,"R",8,"R",6,"R",14
213057,7,"R",8,"R",6,"R",14
213598,5,"R",1,"Z",0,"R",1
213598,7,"R",1,"Z",0,"R",1
214713,4,"R",1,"Z",0,"R",1
214713,7,"R",1,"Z",0,"R",1
214731,4,"Z",0,"R",1,"R",1
214731,7,"Z",0,"R",1,"R",1
214777,1,"Z",0,"R",1,"R",1
214777,3,"R",12,"R",3,"R",15
214777,4,"R",4,"R",5,"R",9
214777,5,"Z",0,"R",1,"R",1
214777,7,"R",16,"R",10,"R",26
214971,1,"R",1,"Z",0,"R",1
214971,7,"R",1,"Z",0,"R",1
215433,4,"Z",0,"R",1,"R",1
215433,7,"Z",0,"R",1,"R",1
215637,4,"R",3,"R",1,"R",4
215637,7,"R",3,"R",1,"R",4
216597,1,"R",1,"R",1,"R",2
216597,3,"R",1,"R",2,"R",3
216597,4,"R",1,"R",1,"R",2
216597,7,"R",3,"R",4,"R",7
217077,4,"R",5,"R",6,"R",11
217077,7,"R",5,"R",6,"R",11
217156,6,"R",7,"R",5,"R",12
217156,7,"R",7,"R",5,"R",12
217235,1,"Z",0,"R",1,"R",1
217235,7,"Z",0,"R",1,"R",1
218229,1,"R",1,"R",1,"R",2
218229,4,"Z",0,"R",2,"R",2
218229,7,"R",1,"R",3,"R",4
220604,4,"R",1,"Z",0,"R",1
220604,7,"R",1,"Z",0,"R",1
220631,3,"Z",0,"R",1,"R",1
220631,4,"Z",0,"R",1,"R",1
220631,7,"Z",0,"R",2,"R",2
222576,4,"Z",0,"R",1,"R",1
222576,7,"Z",0,"R",1,"R",1
222831,5,"R",1,"R",1,"R",2
222831,6,"Z",0,"R",2,"R",2
222831,7,"R",1,"R",3,"R",4
222877,1,"R",4,"R",1,"R",5
222877,7,"R",4,"R",1,"R",5
223506,4,"R",1,"Z",0,"R",1
223506,7,"R",1,"Z",0,"R",1
224147,6,"R",29,"R",53,"R",82
224147,7,"R",29,"R",53,"R",82
224439,4,"R",15,"R",5,"R",20
224439,7,"R",15,"R",5,"R",20
225432,5,"R",2,"R",9,"R",11
225432,6,"Z",0,"R",3,"R",3
225432,7,"R",2,"R",12,"R",14
225502,5,"Z",0,"R",1,"R",1
225502,7,"Z",0,"R",1,"R",1
225511,5,"R",4,"R",4,"R",8
225511,6,"R",2,"R",1,"R",3
225511,7,"R",6,"R",5,"R",11
226408,3,"Z",0,"R",1,"R",1
226408,7,"Z",0,"R",1,"R",1
226833,6,"R",19,"R",23,"R",42
226833,7,"R",19,"R",23,"R",42
227182,2,"R",1,"R",1,"R",2
227182,3,"R",1,"R",1,"R",2
227182,4,"R",24,"R",31,"R",55
227182,7,"R",26,"R",33,"R",59
227216,6,"R",25,"R",41,"R",66
227216,7,"R",25,"R",41,"R",66
227526,5,"R",11,"R",8,"R",19
227526,7,"R",11,"R",8,"R",19
227854,6,"R",7,"R",6,"R",13
227854,7,"R",7,"R",6,"R",13
227881,5,"R",46,"R",57,"R",103
227881,7,"R",46,"R",57,"R",103
227924,6,"R",11,"R",10,"R",21
227924,7,"R",11,"R",10,"R",21
228325,4,"R",1,"Z",0,"R",1
228325,7,"R",1,"Z",0,"R",1
228529,4,"R",2,"Z",0,"R",2
228529,7,"R",2,"Z",0,"R",2
228547,4,"R",3,"R",1,"R",4
228547,7,"R",3,"R",1,"R",4
228723,1,"R",8,"Z",0,"R",8
228723,2,"R",1,"Z",0,"R",1
228723,3,"R",4,"R",1,"R",5
228723,4,"R",1,"Z",0,"R",1
228723,5,"R",6,"R",11,"R",17
228723,6,"Z",0,"R",1,"R",1
228723,7,"R",20,"R",13,"R",33
229027,1,"R",3,"Z",0,"R",3
229027,2,"R",1,"Z",0,"R",1
229027,3,"R",1,"Z",0,"R",1
229027,5,"R",8,"R",17,"R",25
229027,7,"R",13,"R",17,"R",30
230038,1,"R",4,"R",4,"R",8
230038,2,"Z",0,"R",2,"R",2
230038,3,"R",2,"Z",0,"R",2
230038,4,"Z",0,"R",5,"R",5
230038,7,"R",6,"R",11,"R",17
230056,4,"R",1,"R",4,"R",5
230056,7,"R",1,"R",4,"R",5
231174,5,"R",2,"R",1,"R",3
231174,7,"R",2,"R",1,"R",3
231624,4,"R",2,"R",1,"R",3
231624,6,"R",1,"Z",0,"R",1
231624,7,"R",3,"R",1,"R",4
232016,4,"R",2,"R",6,"R",8
232016,7,"R",2,"R",6,"R",8
232308,3,"R",1,"Z",0,"R",1
232308,7,"R",1,"Z",0,"R",1
233329,4,"Z",0,"R",1,"R",1
233329,7,"Z",0,"R",1,"R",1
233374,4,"Z",0,"R",1,"R",1
233374,6,"R",1,"R",1,"R",2
233374,7,"R",1,"R",2,"R",3
233611,1,"R",5,"R",5,"R",10
233611,2,"R",8,"R",5,"R",13
233611,3,"R",8,"R",5,"R",13
233611,4,"Z",0,"R",2,"R",2
233611,7,"R",21,"R",17,"R",38
234526,4,"R",2,"Z",0,"R",2
234526,7,"R",2,"Z",0,"R",2
234669,6,"Z",0,"R",1,"R",1
234669,7,"Z",0,"R",1,"R",1
234933,6,"R",2,"R",4,"R",6
234933,7,"R",2,"R",4,"R",6
234951,4,"R",2,"R",1,"R",3
234951,7,"R",2,"R",1,"R",3
234979,6,"Z",0,"R",1,"R",1
234979,7,"Z",0,"R",1,"R",1
235316,2,"R",1,"Z",0,"R",1
235316,3,"R",1,"Z",0,"R",1
235316,4,"Z",0,"R",1,"R",1
235316,7,"R",2,"R",1,"R",3
235671,4,"R",1,"R",1,"R",2
235671,7,"R",1,"R",1,"R",2
235750,6,"R",1,"Z",0,"R",1
235750,7,"R",1,"Z",0,"R",1
236072,6,"R",2,"Z",0,"R",2
236072,7,"R",2,"Z",0,"R",2
236258,6,"R",1,"Z",0,"R",1
236258,7,"R",1,"Z",0,"R",1
236328,1,"R",1,"R",1,"R",2
236328,3,"R",1,"Z",0,"R",1
236328,4,"Z",0,"R",2,"R",2
236328,7,"R",2,"R",3,"R",5
236382,4,"R",3,"R",1,"R",4
236382,7,"R",3,"R",1,"R",4
236504,6,"R",2,"R",3,"R",5
236504,7,"R",2,"R",3,"R",5
236513,6,"R",3,"R",6,"R",9
236513,7,"R",3,"R",6,"R",9
236595,4,"Z",0,"R",1,"R",1
236595,6,"R",18,"R",21,"R",39
236595,7,"R",18,"R",22,"R",40
236638,6,"Z",0,"R",4,"R",4
236638,7,"Z",0,"R",4,"R",4
236753,6,"Z",0,"R",1,"R",1
236753,7,"Z",0,"R",1,"R",1
236887,6,"R",3,"R",4,"R",7
236887,7,"R",3,"R",4,"R",7
236948,3,"Z",0,"R",1,"R",1
236948,5,"R",1,"R",1,"R",2
236948,7,"R",1,"R",2,"R",3
239442,6,"R",1,"R",1,"R",2
239442,7,"R",1,"R",1,"R",2
240116,6,"R",4,"R",6,"R",10
240116,7,"R",4,"R",6,"R",10
240505,6,"R",1,"Z",0,"R",1
240505,7,"R",1,"Z",0,"R",1
241395,6,"R",1,"R",1,"R",2
241395,7,"R",1,"R",1,"R",2
241410,6,"R",15,"R",28,"R",43
241410,7,"R",15,"R",28,"R",43
242121,1,"Z",0,"R",3,"R",3
242121,7,"Z",0,"R",3,"R",3
242565,1,"R",3,"R",6,"R",9
242565,7,"R",3,"R",6,"R",9
243072,6,"R",2,"R",6,"R",8
243072,7,"R",2,"R",6,"R",8
243179,3,"Z",0,"R",1,"R",1
243179,4,"R",2,"R",8,"R",10
243179,7,"R",2,"R",9,"R",11
243188,4,"R",3,"R",1,"R",4
243188,7,"R",3,"R",1,"R",4
243197,3,"R",3,"R",7,"R",10
243197,4,"R",3,"R",3,"R",6
243197,7,"R",6,"R",10,"R",16
243212,4,"R",6,"R",12,"R",18
243212,7,"R",6,"R",12,"R",18
243221,1,"R",1,"R",1,"R",2
243221,2,"Z",0,"R",1,"R",1
243221,3,"R",13,"R",20,"R",33
243221,4,"R",13,"R",10,"R",23
243221,7,"R",27,"R",32,"R",59
243586,6,"R",2,"R",1,"R",3
243586,7,"R",2,"R",1,"R",3
243647,2,"Z",0,"R",1,"R",1
243647,4,"R",5,"R",1,"R",6
243647,7,"R",5,"R",2,"R",7
243832,4,"R",1,"R",4,"R",5
243832,7,"R",1,"R",4,"R",5
246354,6,"R",8,"R",9,"R",17
246354,7,"R",8,"R",9,"R",17
249609,4,"R",6,"R",1,"R",7
249609,7,"R",6,"R",1,"R",7
262129,3,"R",1,"Z",0,"R",1
262129,7,"R",1,"Z",0,"R",1
363721,1,"R",2,"Z",0,"R",2
363721,7,"R",2,"Z",0,"R",2
365204,4,"R",3,"R",17,"R",20
365204,7,"R",3,"R",17,"R",20
366252,5,"R",1,"R",1,"R",2
366252,7,"R",1,"R",1,"R",2
366401,4,"R",4,"R",5,"R",9
366401,7,"R",4,"R",5,"R",9
373447,4,"R",1,"R",3,"R",4
373447,7,"R",1,"R",3,"R",4
375939,4,"Z",0,"R",1,"R",1
375939,7,"Z",0,"R",1,"R",1
376385,1,"R",10,"R",12,"R",22
376385,7,"R",10,"R",12,"R",22
377342,4,"R",2,"R",1,"R",3
377342,7,"R",2,"R",1,"R",3
377449,4,"R",5,"R",9,"R",14
377449,7,"R",5,"R",9,"R",14
377458,4,"R",4,"R",12,"R",16
377458,7,"R",4,"R",12,"R",16
377564,2,"R",1,"Z",0,"R",1
377564,3,"Z",0,"R",1,"R",1
377564,7,"R",1,"R",1,"R",2
389727,4,"Z",0,"R",3,"R",3
389727,7,"Z",0,"R",3,"R",3
395362,4,"R",2,"R",4,"R",6
395362,7,"R",2,"R",4,"R",6
399212,4,"R",6,"R",6,"R",12
399212,7,"R",6,"R",6,"R",12
402776,6,"R",1,"R",1,"R",2
402776,7,"R",1,"R",1,"R",2
404338,1,"R",4,"Z",0,"R",4
404338,2,"R",4,"Z",0,"R",4
404338,7,"R",8,"Z",0,"R",8
404921,4,"R",2,"R",2,"R",4
404921,7,"R",2,"R",2,"R",4
406200,4,"R",20,"R",29,"R",49
406200,7,"R",20,"R",29,"R",49
408844,4,"R",47,"R",37,"R",84
408844,7,"R",47,"R",37,"R",84
409315,4,"R",7,"R",10,"R",17
409315,7,"R",7,"R",10,"R",17
414461,1,"R",58,"R",34,"R",92
414461,7,"R",58,"R",34,"R",92
420024,4,"R",5,"R",3,"R",8
420024,7,"R",5,"R",3,"R",8
420398,6,"R",7,"R",28,"R",35
420398,7,"R",7,"R",28,"R",35
427973,4,"R",21,"R",2,"R",23
427973,7,"R",21,"R",2,"R",23
427982,4,"R",1,"R",7,"R",8
427982,7,"R",1,"R",7,"R",8
430157,4,"R",1,"Z",0,"R",1
430157,7,"R",1,"Z",0,"R",1
437662,4,"R",1,"Z",0,"R",1
437662,7,"R",1,"Z",0,"R",1
439507,4,"R",1,"R",2,"R",3
439507,7,"R",1,"R",2,"R",3
440378,4,"R",1,"R",2,"R",3
440378,7,"R",1,"R",2,"R",3
441502,4,"Z",0,"R",4,"R",4
441502,7,"Z",0,"R",4,"R",4
441636,6,"Z",0,"R",2,"R",2
441636,7,"Z",0,"R",2,"R",2
441858,4,"Z",0,"R",11,"R",11
441858,7,"Z",0,"R",11,"R",11
441928,4,"R",5,"R",4,"R",9
441928,7,"R",5,"R",4,"R",9
442745,4,"R",1,"R",2,"R",3
442745,7,"R",1,"R",2,"R",3
443058,6,"R",1,"Z",0,"R",1
443058,7,"R",1,"Z",0,"R",1
443128,1,"R",5,"R",4,"R",9
443128,7,"R",5,"R",4,"R",9
444219,4,"Z",0,"R",1,"R",1
444219,7,"Z",0,"R",1,"R",1
445018,4,"R",1,"R",3,"R",4
445018,7,"R",1,"R",3,"R",4
445762,4,"R",14,"R",2,"R",16
445762,7,"R",14,"R",2,"R",16
446446,4,"R",5,"R",18,"R",23
446446,7,"R",5,"R",18,"R",23
446613,1,"R",1,"Z",0,"R",1
446613,7,"R",1,"Z",0,"R",1
447050,2,"Z",0,"R",3,"R",3
447050,3,"R",1,"R",1,"R",2
447050,4,"Z",0,"R",2,"R",2
447050,7,"R",1,"R",6,"R",7
447847,4,"R",19,"R",3,"R",22
447847,7,"R",19,"R",3,"R",22
447935,4,"R",1,"R",2,"R",3
447935,7,"R",1,"R",2,"R",3
449612,4,"R",2,"Z",0,"R",2
449612,7,"R",2,"Z",0,"R",2
450960,4,"R",1,"R",3,"R",4
450960,7,"R",1,"R",3,"R",4
451510,6,"Z",0,"R",1,"R",1
451510,7,"Z",0,"R",1,"R",1
452115,4,"R",35,"R",11,"R",46
452115,7,"R",35,"R",11,"R",46
453747,4,"R",8,"R",7,"R",15
453747,7,"R",8,"R",7,"R",15
454838,6,"Z",0,"R",1,"R",1
454838,7,"Z",0,"R",1,"R",1
456056,4,"R",2,"R",2,"R",4
456056,7,"R",2,"R",2,"R",4
456454,4,"R",1,"R",7,"R",8
456454,7,"R",1,"R",7,"R",8
456816,6,"R",1,"R",8,"R",9
456816,7,"R",1,"R",8,"R",9
458593,4,"R",2,"R",9,"R",11
458593,7,"R",2,"R",9,"R",11
458733,6,"R",4,"R",7,"R",11
458733,7,"R",4,"R",7,"R",11
458751,6,"Z",0,"R",7,"R",7
458751,7,"Z",0,"R",7,"R",7
458760,6,"R",1,"R",6,"R",7
458760,7,"R",1,"R",6,"R",7
458779,4,"R",2,"R",7,"R",9
458779,7,"R",2,"R",7,"R",9
459091,4,"R",2,"R",2,"R",4
459091,7,"R",2,"R",2,"R",4
459417,5,"Z",0,"R",1,"R",1
459417,7,"Z",0,"R",1,"R",1
460394,4,"R",3,"Z",0,"R",3
460394,7,"R",3,"Z",0,"R",3
460774,4,"R",2,"R",3,"R",5
460774,7,"R",2,"R",3,"R",5
460844,4,"R",2,"R",1,"R",3
460844,7,"R",2,"R",1,"R",3
460923,4,"R",1,"R",9,"R",10
460923,7,"R",1,"R",9,"R",10
461281,1,"Z",0,"R",5,"R",5
461281,7,"Z",0,"R",5,"R",5
461643,6,"R",1,"R",2,"R",3
461643,7,"R",1,"R",2,"R",3
461759,6,"R",5,"R",1,"R",6
461759,7,"R",5,"R",1,"R",6
462354,1,"R",4,"R",2,"R",6
462354,7,"R",4,"R",2,"R",6
466514,6,"Z",0,"R",5,"R",5
466514,7,"Z",0,"R",5,"R",5
475033,3,"Z",0,"R",6,"R",6
475033,7,"Z",0,"R",6,"R",6
